{   
    "name" : "Empty room",
    "init_position" : {"x" : 5 , "y" : 5 , "z" : 0},
    "end_position" : {"x" : 1 , "y" : 1 , "z" : 0},
    "maze" : [[
        [1,1,1,1,1,1,1,1,1,1,1,1], 
        [1,0,0,0,0,0,0,0,0,0,0,1], 
        [1,0,0,0,0,0,0,0,0,0,0,1], 
        [1,0,0,0,0,0,0,0,0,0,0,1], 
        [1,0,0,0,0,0,0,0,0,0,0,1], 
        [1,0,0,0,0,0,0,0,0,0,0,1], 
        [1,0,0,0,0,0,0,0,0,0,0,1], 
        [1,0,0,0,0,0,0,0,0,0,0,1], 
        [1,0,0,0,0,0,0,0,0,0,0,1], 
        [1,0,0,0,0,0,0,0,0,0,0,1], 
        [1,1,1,1,1,1,1,1,1,1,1,1]],
        [0]]
}