{   
    "name" : "First maze",
    "init_position" : {"x" : 9 , "y" : 7 , "z" : 0},
    "end_position" : {"x" : 5 , "y" : 21 , "z" : 0},
    "maze" : [[
        [1,1,1,1,1,1,1,1,1,1,1,1,1,1,1,1,1,1], 
        [1,0,0,1,0,0,1,0,0,0,1,1,1,1,1,0,1,1], 
        [1,0,0,1,0,1,1,0,1,0,1,0,0,0,0,0,0,1], 
        [1,1,0,1,0,1,0,0,1,0,1,0,1,1,0,1,0,1], 
        [1,1,0,1,0,1,0,1,1,0,1,0,1,1,0,1,0,1], 
        [1,0,0,0,0,0,0,0,0,0,0,0,1,1,1,1,0,1], 
        [1,1,1,1,1,1,1,1,2,0,2,1,1,1,1,0,0,1], 
        [1,1,0,0,0,0,0,0,0,0,0,0,0,0,1,0,1,1], 
        [1,1,0,1,1,1,1,1,2,0,2,1,1,0,1,0,1,1], 
        [1,1,0,0,0,0,1,0,1,0,1,0,0,0,1,0,1,1], 
        [1,1,0,1,1,0,1,0,1,0,1,1,0,1,1,0,1,1], 
        [1,0,0,0,1,0,0,0,0,0,0,1,0,1,0,0,0,1], 
        [1,0,1,0,1,1,1,1,0,1,0,0,0,1,0,1,0,1], 
        [1,0,1,0,0,0,0,1,0,1,1,1,0,1,0,1,0,1], 
        [1,0,1,1,0,1,0,1,0,0,0,1,0,1,0,1,1,1], 
        [1,0,1,0,1,1,0,1,1,1,1,0,0,1,0,1,0,1], 
        [1,0,0,0,0,0,0,1,0,0,0,0,0,0,0,0,0,1], 
        [1,0,1,1,1,1,1,1,1,1,1,1,1,1,1,1,1,1], 
        [1,0,0,0,0,0,0,0,0,0,0,0,0,1,0,1,1,1], 
        [1,0,1,1,1,1,1,0,1,0,1,0,1,1,0,0,0,1], 
        [1,0,0,0,1,3,1,0,1,0,1,0,0,0,0,1,0,1], 
        [1,1,1,1,1,0,1,1,1,0,1,1,1,1,1,1,0,1], 
        [1,0,0,0,0,0,1,0,0,0,1,0,0,0,0,0,0,1], 
        [1,0,1,1,1,1,1,1,1,1,1,0,1,1,1,1,1,1], 
        [1,0,0,0,0,0,0,0,0,0,0,0,1,1,1,1,1,1], 
        [1,1,1,1,1,1,1,1,1,1,1,1,1,1,1,1,1,1]],
        [0]]
}