{   
    "name" : "Test maze",
    "init_position" : {"x" : 1 , "y" : 7 , "z" : 0},
    "end_position" : {"x" : 9 , "y" : 1 , "z" : 0},
    "maze" : [[
        [1, 1, 1, 1, 1, 1, 1, 1, 1, 1, 1],
        [1, 0, 3, 0, 3, 0, 3, 0, 3, 0, 1], 
        [1, 3, 3, 0, 3, 0, 3, 0, 3, 0, 1], 
        [1, 0, 0, 0, 3, 0, 3, 0, 0, 0, 1], 
        [1, 3, 3, 0, 3, 0, 3, 0, 3, 3, 1], 
        [1, 0, 0, 0, 3, 0, 0, 0, 0, 0, 1], 
        [1, 3, 3, 0, 3, 0, 3, 0, 3, 3, 1], 
        [1, 0, 0, 0, 0, 0, 3, 0, 0, 0, 1], 
        [1, 3, 3, 0, 3, 0, 3, 0, 3, 3, 1], 
        [1, 0, 3, 0, 3, 0, 3, 0, 3, 0, 1], 
        [3, 3, 3, 3, 3, 3, 3, 3, 3, 1, 1],
        [1, 1, 1, 1, 1, 1, 1, 1, 1, 1, 1]],[0]]
}