{   
    "name" : "Another maze",
    "init_position" : {"x" : 18 , "y" : 1 , "z" : 0},
    "end_position" : {"x" : 2 , "y" : 12 , "z" : 0},
    "maze" : [[
        [1,1,1,1,1,1,1,1,1,1,1,1,1,1,1,1,1,1,1,1],
        [1,0,0,0,0,0,0,1,0,0,0,1,0,0,0,0,0,0,0,1],
        [1,1,0,1,1,1,0,1,0,1,0,0,0,1,0,1,0,1,0,1],
        [1,0,2,1,1,0,0,2,0,2,1,1,1,1,0,1,0,1,0,1],
        [1,0,0,0,0,0,0,2,0,2,1,0,0,0,0,0,0,1,0,1],
        [1,0,0,0,0,0,0,1,0,2,1,0,0,1,0,1,0,1,0,1],
        [1,0,0,0,0,0,0,1,0,2,1,0,1,1,1,1,0,1,0,1],
        [1,0,0,1,0,0,0,1,0,2,1,0,1,0,0,0,0,1,1,1],
        [1,1,0,1,0,1,0,1,0,2,1,0,1,0,1,1,1,1,0,1],
        [1,0,0,0,0,1,0,1,0,2,1,0,1,0,0,0,0,0,0,1],
        [1,1,0,1,1,1,0,1,0,2,1,0,1,0,1,1,0,1,1,1],
        [1,0,0,0,0,0,0,0,0,2,1,0,1,0,0,0,0,0,0,1],
        [1,0,1,1,1,1,1,1,0,2,1,0,1,1,1,1,1,1,0,1],
        [1,0,0,0,0,0,0,1,0,0,2,2,2,0,0,0,0,1,0,1],
        [2,3,0,0,0,0,0,0,0,0,0,0,0,0,2,0,2,0,0,1],
        [1,2,2,2,2,2,2,2,2,2,2,2,2,2,2,2,2,1,1,1]],
        [0]]
}